111111111111111111111111111111
1P0000000000000000000000000001
10000000CCCC000000000000000001
100000011111100100000000000001
100000000000000001111100000001
100000000000000000000000000001
100000000100001001010011111111
1000C1010000110C01101000001101
1011110C01000000010010000CC111
101C00010111111111011000000001
10111001000C100000000000000001
101000010000100000000000000001
100000000001111111000000000001
1000000000000000000000000000E1
111111111111111111111111111111