11111111111111111111111111
10010010100010100010100101
10000000101111001010111011
11110010010100010101110011
11111111111111111111111111