1111111111111111111111111
10010010100P1010001010011
1000000010111100101011101
11110010C1010001E10111001
1111111111111111111111111