11111111111111111
1P000000000000C01
100001111111000C1
1E00111CCC1110001
1000CCCCCCCCC0001
1000CCCCCCCCC0001
1000111CCC1110001
10000111111110001
10000000000100001
11111111111111111