1111111111111111111111111
1001P01010000110E01000C11
100C000010010100101011101
1111001000010C00000011001
1111111111111111111111111