11111111111111111
1P000000000000001
10000111111100001
1000111CCC1110001
1000CCCCCCCCC0001
1000CCCCCCCCC0001
1000111CCC1110001
10000111111100001
100000000000000E1
11111111111111111