1111111111111111111111111
1001P0101000101E001010011
100C000010111100101011101
1111001001010001010111001
1111111111111111111111111