1111111111111111111111111
1001001010001010001010011
1000000010111100101011101
1111001001010001010111001
1111111111111111111111111