1111111111111
100100C0000C1
1C00011111001
1000111000001
1000000000001
1000000P00001
100100C0000C1
1C00011111001
100011E000001
1111111111111