11111111111111111
10000P00000000001
10000000000000001
10000C00000000001
11111111111110111
10000000000001E01
11111111111111111