111111111111111111111
1C100001E000000C010C1
100001011111100101011
101111010000100101001
1000C1010000110C01101
1011110C0100000001001
101C00010111111111011
10111001000P100000001
101000010000100001001
1C10000100000000010C1
111111111111111111111